staple: Elemento basico
flaws: fallas
oversights: descuidos
compensate: compensar
intended: intencionado
rubs: frontar
sleeve: manga
ecstatic: extatica
briefcase: maletin
thin: delgada
wide eye: Ojo ancho
amazement: asombro
puff: soplo
grant: conceder
miscounted: malcontado, equivocarse en la cuenta
foot fence: Cerca de pie
fence post: poste de cerca
glance: vistazo
counterintuitive: contraintuitivo
marketable: comerciable
accomplish: realizar
traverse: atravezar
backward through: hacia atras a traves
deface: desfigurar
realm: reino
sidesteps: esquivar
grand jury: gran jurado
glaringly: deslumbrante
hindsight: comprension retrospectiva
tricking: enga√±ando
smuggled: de contrabando
cliff: acantilado
shifted: desplazado
spill out: derramarse
annoying: molesto
downright: completamente